#####################
#***********Z*******#
#*##*###*##*###*###*#
#*##*#.#*##*###*###*#
#*##*###*##*###*###*#
#*******************#
#*###*#*#####*#*###*#
#*###*#***#***#*###*#
#**Y**###*#*###*****#
#####*#*******#*#####
#####*#*#####*#*#####
#*******#...#*******#
#####*#*#####*#*#####
#####*#o******#*#####
#*****#*#####*#*****#
#*###*#***#***#*###*#
#**##***#***#***##**#
##*##*#*#####*#*##*##
#*****#***#***#*X***#
#*#######*#*#######*#
#***V***************#
#####################
